
R 4294967900 4294967900

NO ./textures/basic/north.xpm

SO ./textures/basic/south.xpm

WE ./textures/basic/west.xpm

EA ./textures/basic/east.xpm

S ./sprites/2/2.xpm

F 140,140,140

C 220,220,220

1111111111111111111
1E00200011100020001
1000100002000010001
1000000000000000001
1100000011100000011
1100000011100200011
1000000000000000001
1000100000000010001
1000000211120000001
1111111111111111111