R 1200 800

NO none

SO none

WE none

EA none

S none

F 0,0,0

C 0,0,0

111111111111111111111111111111111111111
100000010000000000000000000000000000001
100000000000000000000000000000000000001
100000010000000000000000000000000000001
100000010000000000000000000000000000001
100000010000001111111111111111111111111
10000001000001111
10000001000011111
10000001000111111
10000001001111111
11111111000000001
10000001000000001
10000001000001001
10010111000001001
10N10001110111001
11111101000001001
10000001111111001
11000000000000001
11111111111111111