R 1200 800

NO none

SO none

WE none

EA none

S none

F 0,0,0

C 0,0,0

     11111111111111
     10000001000011
1111110000001000011
1000010000001111001
1000010000101111001
1111000N00000000001
1  1010000001000001
1111111000001110011
 100001000000010001
 100001000000010001
 100000111111110001
 100000000000000001
 111111111111111111