R 1200 800

NO none

SO none

WE none

EA none

S none

F 0,0,0

C 0,0,0

   1111111111111111
   1010000001000001
1111000000000000001
1E00010000111111001
1000010000111111001
1111000000000000001
1  1010000001000001
1111111111111110011
 100001       10001
 100001       10001
 100000111111110001
 100000000000000001
 111111111111111111