
R 1200 800

NO ./textures/n.xpm

SO ./textures/s.xpm

WE ./textures/w.xpm

EA ./textures/e.xpm

S ./path_to_the_sprite_texture

F 66,100,0

C 255,30,0

111111111111111111111111
100100100000000010000001
101001000001100001000001
10000000000000000000001
100000000111111000000001
1010001001    1001000001
10000N100111111001000001
100010000000000000000001
10001000001100001001101
100000100000000010000001
111111111111111111111111
