
R 1920 1080

NO ./path_to_the_north_texture

SO ./path_to_the_south_texture

WE ./path_to_the_west_texture

EA ./path_to_the_east_texture

S ./path_to_the_sprite_texture

F 66,100,0

C 255,30,0


1111111
10N0001
1001001
101 101
10010011
10000000111111
10000000000001
1000000111111
1111111
