
R 1200 800

NO ./textures/s.xpm

SO ./textures/w.xpm

WE ./textures/s.xpm

EA ./textures/w.xpm

S ./path_to_the_sprite_texture

F 66,100,0

C 255,30,0

111111111111111111111111
100100100000000010000001
101001000001100001000001
10000000000000000000001
100000000111111000000001
101001001    12E1000001
100000100111111001000001
100010000000000000000001
10001000001100001001101
10000100000000010000001
111111111111111111111111
