
R 1200 800

NO ./path_to_the_north_texture

SO ./path_to_the_south_texture

WE ./textures/popug.xpm

EA ./path_to_the_east_texture

S ./path_to_the_sprite_texture

F 66,100,0

C 255,30,0

111111111111111111111111
1N0100100000000010000001
101001000001100001000001
100000000000000000000001
100000000111111000000001
1000001001    1001000001
100000100111111001000001
100000000000000000000001
101101000001100001001101
100000100000000010000001
111111111111111111111111
