
R 1200 800

NO ./path_to_the_north_texture

SO ./path_to_the_south_texture

WE ./path_to_the_west_texture

EA ./path_to_the_east_texture

S ./path_to_the_sprite_texture

F 66,100,0

C 255,30,0

111111111111111111111111
1N0000100000000010000001
100001000001100001000001
100000000000000000000001
100100000111111000001001
1001000001    1000001001
100100000111111000001001
100000000000000000000001
100001000001100001000001
100000100000000010000001
111111111111111111111111
