R 1920 1080

NO ./path_to_the_north_texture

SO ./path_to_the_south_texture

WE ./path_to_the_west_texture

EA ./path_to_the_east_texture

S ./path_to_the_sprite_texture

F 66,100,0

C 255,30,0


1111111
12N011
1001001
121 101
1111111
