R 1920 1080

NO ./path_to_the_north_texture


SO ./path_to_the_south_texture



WE ./path_to_the_west_texture




EA ./path_to_the_east_texture

S ./path_to_the_sprite_texture



F200,100,0

C 225300





1111111
1000001
1N01001
101 101
1111111
