
R 1200 800

NO ./textures/s.xpm

SO ./textures/w.xpm

WE ./textures/s.xpm

EA ./textures/w.xpm

S ./sprites/2/2.xpm

F 66,100,0

C 255,30,0

1111111111111111111
1E00200011100020001
1000100002000010001
1000000000000000001
1100000011100000011
1100000011100200011
1000000000000000001
1001000000000001001
1000000211120000001
1111111111111111111
