
R 1270 800

NO ./path_to_the_north_texture

SO ./path_to_the_south_texture

WE ./path_to_the_west_texture

EA ./path_to_the_east_texture

S ./path_to_the_sprite_texture

F 66,100,0

C 255,30,0

111111111
1000000001111111111111
1001111000000000000001
1000100011100000000001
1000N00010000001111111
1000000000000000001111
111111111111111111111
