
R 1920 1080

NO ./path_to_the_north_texture

SO ./path_to_the_south_texture

WE ./path_to_the_west_texture

EA ./path_to_the_east_texture

S ./path_to_the_sprite_texture

F 66,100,0

C 255,30,0


1111111111111111111111111
10000000000000000000000001
10010000000111111100000001
10010000001111110000000001
101 1010000111100000000001
10010011111111111111111111
10000000111111000000000001
100N0000000001111111111111
10000001111111100000001111
11111111111111111111111111
